%%%%%%%%%%%%%%%%%%%%
%P.................%
%                 .%
%                 .%
%                 .%
%%%%%%%%%%%%%%%%%%%%
